
    OOOOO             
    O   O             
    OC  O             
  OOO   OOO           
  O     C O           
OOO O OOO O     OOOOOO
O   O OOO OOOOOOO   XO
O P   C             XO
OOOOO OOOO OOOOOO   XO
    O      OOO  OOOOOO
    OOOOOOOO          
