
OOOOOOOOOOOO  
OX   O     OOO
OX   O C  C  O
OX   O OOOO  O
OX     P OO  O
OX   O O    OO
OOOOOO OO  C O
  O C  C     O
  O    O     O
  OOOOOOOOOOOO
