
              OOOOOOOO
              O    XXO
   OOOOOOOOOOOO    XXO
   O    O  C C     XXO
   O  OC      O    XXO
   O  C     C O    XXO
   O    OC C COOOOOOOO
OOOO  C O     O       
O   O OOOOOOOOO       
O    C  OO            
O   O C PO            
O   O   OO            
OOOOOOOOO             
