
OOOOOO  OOO 
OX   O OOPOO
OX   OOO   O
OX      C  O
OX   O O   O
OX OOO O C O
OOOO C O   O
   O   O C O
   O    C  O
   O  OO   O
   OOOOOOOOO
