
    OOOOO             
    O   O             
    OC  O             
  OOO  COOO           
  O  C  C O           
OOO O OOO O     OOOOOO
O   O OOO OOOOOOO  XXO
O C  C             XXO
OOOOO OOOO OPOOOO  XXO
    O      OOO  OOOOOO
    OOOOOOOO          
