
       OOOOO 
 OOOOOOO   OO
OO O POO CC O
O    C      O
O  C  OOO   O
OOO OOOOOCOOO
O C  OOO XXO 
O C C C XXXO 
O    OOOXXXO 
O CC O OXXXO 
O  OOO OOOOO 
OOOO         
