
       OOOOO 
 OOOOOOO   OO
OO O POO C  O
O           O
O  C  OOO   O
OOO OOOOOCOOO
O C  OOO  XO 
O     C  XXO 
O    OOO XXO 
O C  O O  XO 
O  OOO OOOOO 
OOOO         
