
OOOOOO  OOO 
OXX  O OOPOO
OXX  OOO   O
OXX     CC O
OXX  O O C O
OXXOOO O C O
OOOO C OC  O
   O  CO C O
   O C  C  O
   O  OO   O
   OOOOOOOOO