
          OOOOOOO
          O   XXO
      OOOOO    XO
      O       XXO
      O  OO    XO
      OO OO   XXO
     OOO OOOOOOOO
     O C   OO    
 OOOOO    C OOOOO
OO   OC C   O   O
OP C       C  C O
OOOOOO    C OOOOO
     O C    O    
     OOOO OOO    
        O  O     
        O  O     
        O  O     
        OOOO     
