
OOOOOOOOOOOO  
OXX  O     OOO
OXX  O C  C  O
OXX  OCOOOO  O
OXX    P OO  O
OXX  O O  C OO
OOOOOO OOC C O
  O C  C C C O
  O    O     O
  OOOOOOOOOOOO