
        OOOOO    
        O   OOOOO
        O OCOO  O
        O     C O
OOOOOOOOO OOO   O
OXX    OO C  COOO
OXX      C    OO 
OXX    OO     PO 
OOOOOOOOO  C  OO 
        O      O 
        OOO OO O 
          O    O 
          OOOOOO 
