
  OOOO          
  O  OOOOOOOOOOO
  O    C     C O
  O  O   O  C  O
  O       O    O
OOO CO O  OOOO O
OPOC   C  OO   O
O      OCO   O O
OO  C    C     O
 OOOO  OOOOOOOOO
  OOO  OOO      
  O      O      
  O      O      
  O      O      
  OXX  XXO      
  OXX  XXO      
  OOOOOOOO
