
	      OOOOOOOO
              O  XXXXO
   OOOOOOOOOOOO  XXXXO
   O    O  C C   XXXXO
   O CCCOC  C O  XXXXO
   O  C     C O  XXXXO
   O CC OC C COOOOOOOO
OOOO  C O     O       
O   O OOOOOOOOO       
O    C  OO            
O CCOCC PO            
O   O   OO            
OOOOOOOOO             
