
        OOOOOOOO 
        O     PO 
        O CO  OO 
        O     CO  
        OO  C O  
OOOOOOOOO   O OOO
OXX    OO       O
OOX      C  C   O
OXX    OOOOOOOOOO
OOOOOOOO         
